                           wiliyam : xEkspir:: 

  xEkspir : yemibalew : yeIngliz : tewelaj : yehone : tEatr : SeHafe : ba\10500604 : 
`a : m : teweldo : ba\10600106 : `a : m : mot:: bemejemeriya : gizE : yexEkspirn : 
yeHywet : tarik : yeSafu : sewoc : gmaxocu : ye`sga : xeyaC : lj : neber : silu : 
gmaxocum : yeqWeda : faqi : lj : new : ylu : neber : Indezihum : abatu : 
lelbs : yemihon : yebeg : TegWur : yxeT : neber : blew : yeSafam : sewoc : 
alu:: kezihm : lEla : degmo : xEkspir : tmhrt : yelElewna : dKa : sew : 
sle : nebere : tEatr : lemayet : wede : tEatr : bEt : kemihEdut : sewoc : lay : 
feresocacewn : Iyeteqebele : kedej : teqemTo : yTebqlacew : neber::  : bezihu : 
mknyat : menfesu : wede : tEatr : `sra : telabe:: behWalam : andand : tEat
r : meSaf : jemro : sle : qenaw : gefabetna : tEatr : lemedres : kef : yale : 
ye`Iwqet : sTota : yalew : bemehonu : IyeqeTelebetna : Iyasfafaw : hEdo : 
yetEatr : derasi : lemehon : beqa : yemilum : sewoc : neberu::  : ahun : gn : 
tarikun : mermrew : yaTarut : sewoc : yexEkspir : abat : balerst : yehone : 
stratford : bemibalew : ager : kemigeNut : begEtnetacew : ketawequt : 
sewoc : gara : abro : yemiqoTer : sew : Inde : neber : asredtewal:: beqi : 
yehone : tmhrt : temro : Inde : nebere : yeteregageTe : neger : honWal:: strat
ford : bemibalew : ager : yegrikna : yelatin : qWanqWawoc : yemiyastemrubet : 
temhrt : bEt : sle : nebere : xEkspir : bezihu : tmhrt : bEt : ketemare : 
behWala : wede : london : hEdo : yeferensay : yeTaliyanna : yespaNol : qWanqWa : Inde : 
temare : ynageralu::

  `esra : sebatna : `esra : semnt : `amet : kemolaw : behWala : rasun : clo : 
lemenor : asbo : yastemarinet : `sra : yazena : bestratford : ager : mist : 
agbto : nore:: keziyam : ljoc : weldo : kemistu : gara : smmnet : slaTa : 
mistunna : ljocun : bestratford : tto : wede : london : ketema : hEde:: 
Iziyam : tEatr : kemiCawetu : sewoc : gara : andnet : hono : yetEatr : 
`sra : y`sera : jemer:: befit : lEloc : yeSafatn : tEatre : Iyareme : 
siyastekakl : qWeyto : behWala : Isu : IyeSafe : tEatrun : azegajto : yasay : 
jemer::

  kexEkspir : befit : tEatr : yemiSfu : marlow-: jorj : pil : jon : lili:
tomas : kid : yemibalu : derasyan : neberu:: xEkspir : betenesa : gizE : gn : kesu : 
befit : weym : besu : gizE : yeneberutn : hulu : belTo : asnaqacew:: 

 ba\10500907 : `a : m : xEkspir : yetEatru : `sra : Iyetesfafalet : hEdo : bzu : 
genzeb : slageNe : wede : teweledebet : stratford : wedemibalew : ageru : hEdo : 
wb : yehone : tlq : bEt : gezto : abatu : Inatu : mistuna : hulet : sEtoc : 
ljocu : bezihu : bEt : wsT : IndiqemeTu : aderege:: 

 beqedmo : gizE : yeHywtun : tarik : yeSafa : sewoc : Inde : bzuwocu : 
baleqnEwoc : hulu : bedKnetna : becgr : noro : yemote : sew : adrgew : 
tenagrewal:: behWala : gn : yeHywetun : tarik : yeSafa : sewoc : baderegut : mrmera : 
masreja : agNtewal::

 xEkspir : yeHywetu : tarik : yeteTara : hono : altegeNem:: mknyatum : 
tlq : baleqnE : mehonu : tawqo : yeHywetun : tarik : lemeSaf : yasebe : 
baletarik : yetegeNew : Isu : kemote : kemeto : `ametat : behWala : bemehonu : new:: 
neger : gn : and : tarik : SeHafi : Inde : tenagerew : sew : yeHywetu : tarik : 
yemigeleTew : letwld : ttot : behEdew : `sra : new : Inji; banWanWaru : 
aydelem:: 

  xEkspir : simot : yekbr : aqebaberna : beHzbm : zend : Teqlala : Hezen : 
altedereletm:: kemot : behWala : and : meto : `ametat : yaKl : qWeyto : 
yeIngliz : ager : sEt : weyzazr : metasebiyawn : lemaqom : baderegut : 
rdata : genzeb : awaTtew : bewEstminster : bEte : krstiyan : bebaleqnEwoc : 
kfl : Hewlt : te`seralet:: xEkspir : tlq : yetEatr : derasi : mehonu : 
yetaweqelet : kebzu : zemen : behWala : new:: beInglizna : beferensay : ageroc : 
Isu : kemote : behWala : Iske : hulet : meto : `ametat : dres : yeneberut : siqawnt : 
gmaxocu : waga : yelElew : derasi : adrgew : gmaxocum : yeSafacewn : tEatroc : 
kelEloc : besu : zemen : keneberu : liqawnt : lay : Iyeteqebele : weym : serqo : 
besu : sm : lewTo : IyaweTa : yatalaynet : `sra : ye`sera : sew : adrgew : 
neqfewtal:: lElaw : qerto : Inde : volitEr : yale : bl`he : sew : InkWa : 
yexEkspir : drsetoc : waga : yalacew : mehonun : zengto : yezemenun : menfes : 
bemeketel : bezih : Ikuya : bemaygeNlet : derasi : lay : bzu : yezelefa : qal : 
tenagrWal:: 

 behWala : gn : `srawn : yemeremeru : liqawnt : xEkspir : be`alem : lay : 
ketefeTerut : asdenaqiwoc : kehonut : derasyanna : baleqnEwoc : malet-: kehomErna : 
kevirZil-: keExilna : kesofokl:kedantEm : gara : abro : yemiqWeTer : tlq : 
baleqnE : mehonun : mesekerulet:: drsetocun : yeSafWacew : bezemenu : yeneberu : 
lEloc : derasyan : nacew : Inji; Isu : alSafacewm : teblo : sleteweraw : 
HemEt : degmo : beyezemenu : yhn : gWuday : yeteketatelu : tarik : mermariwoc : 
bzu : masreja : me`seret : bemadreg : tEatrocun : yeSafacew : Isu : rasu : 
Inji; lEla : derasi : Indalhone : aregagTewletal:: honom : krkru : Iske : 
zaro : dres : sayaqWart : yqeTlal:: 
\
From :  \ kebede : mikaEl:: talalaq : sewoc.\  pp.73-5
